111111111111
100000C00001
100000000C01
100000P00001
1000C0000001
10000000E001
100000000001
111111111111