11111111111111
100000C0000001
100000000C0001
100000P0000001
1000C000000001
10000000E00001
11111111111111