11111
1C1E1
11001
1P001
10001
11111