1111111111
1CPCPCPCP1
1000000C01
1000000001
1000000001
10000P111
10000C0001
1000000001
1000P00001
10C0000001
1C0000E001
1111111111