1111111111111111
100001000C000011
100010000000C011
1001000P00000A11
10100C0000000011
110000010E000011
1111111111111111