11111111111111111
100001000C0000011
100010000000C0011
1001000P000000011
10100C00000000011
110000000E0000011
11111111111111111