11111111111111
100001000C0001
100010000000C1
10010000E00001
10100C00000011
110000010000P1
11111111111111