11111111111111
100001000C0001
1C0010000000C1
1001000P000001
10100C00000001
110000010E0001
11111111111111