111111111111111
100001000C00011
100010000000C11
1001000P000001
10100C00000001
110000010E0001
11111111111111