111111111111111
100001000C00001
100010000000C01
1001000P00000A1
10100C000000001
110000010E00001
111111111111111