1111111
10CE011
1C0P111
1111111