11111111
101E1111
1CP00011
11111111