111111
10C0E1
1C0P01
111111