111111111111111111111111111111111111111
10000000000000000C000000000E00000000011
100000000000000000000000P00000000000011
100000000000000000000000000000000000001
100000000000000000000000000000000000011
100000000000000000000000000000000000001
111111111111111111111111111111111111111
111111111111111111111111111111111111111
111111111111111111111111111111111111111
111111111111111111111111111111111111111
111111111111111111111111111111111111111
111111111111111111111111111111111111111
111111111111111111111111111111111111111
111111111111111111111111111111111111111
111111111111111111111111111111111111111
111111111111111111111111111111111111111
111111111111111111111111111111111111111
111111111111111111111111111111111111111