1111111111111111111111111111111111111
100000C000010000000C00000000000000001
100000000C000000000000000000000000001
100000P000010010101010101010101010101
1000C000000100000C0000000000000000001
10000000E0110100000C00000000000000001
100000000C010010101010101010101010101
1000000000000000000000000000000000001
1000000000000000000000000000000001111
1000000000000000000000000000000000001
1000000000000000000000000000000C01111
1000000000000000000C00000000000000001
100000000C010010101010101010101010101
1000000000000000000000000000000000001
1000000000000000000000000000000001111
1000000000000000000000000000000000001
1000000000000000000000000000000C01111
1000000000000000000C00000000000000001
100000000C010010101010101010101010101
1000000000000000000000000000000000001
1000000000000000000000000000000001111
1000000000000000000000000000000000001
1000000000000000000000000000000C01111
1000000000000000000C00000000000000001
100000000C010010101010101010101010101
1000000000000000000000000000000000001
1000000000000000000000000000000001111
1000000000000000000000000000000000001
1000000000000000000000000000000C01111
1000000000000000000C00000000000000001
100000000C010010101010101010101010101
1000000000000000000000000000000000001
1000000000000000000000000000000001111
1000000000000000000000000000000000001
1000000000000000000000000000000C01111
1000000000000000000C00000000000000001
1111111111111111111111111111111111111